{
  "world": {
    "tileSet" : "images/tiles/tiles.png",
    "frameWidth": 64,
    "frameHeight": 64,
    "framesPerLine": 2,
    "tileMap": [
      [ 1, 1, 1, 1, 1, 1, 1, 1, 1, 1, 1, 1, 1, 1, 1, 1, 1, 1, 1, 1 ],
      [ 1, 1, 1, 1, 1, 1, 1, 1, 1, 1, 1, 1, 1, 1, 1, 1, 1, 1, 1, 1 ],
      [ 1, 3, 3, 3, 3, 3, 3, 1, 1, 1, 1, 1, 1, 1, 1, 1, 1, 1, 1, 1 ],
      [ 1, 1, 2, 1, 1, 1, 3, 3, 1, 1, 1, 1, 1, 1, 1, 1, 1, 1, 1, 1 ],
      [ 1, 2, 1, 1, 1, 1, 1, 3, 1, 2, 2, 1, 1, 1, 1, 1, 1, 1, 1, 1 ],
      [ 1, 1, 1, 1, 1, 1, 1, 1, 1, 2, 2, 1, 1, 1, 1, 1, 1, 1, 1, 1 ],
      [ 1, 1, 1, 1, 1, 1, 1, 1, 1, 1, 1, 1, 1, 1, 1, 1, 1, 1, 1, 1 ],
      [ 1, 1, 1, 1, 1, 1, 1, 1, 1, 1, 1, 1, 1, 1, 1, 1, 1, 1, 1, 1 ],
      [ 1, 1, 1, 1, 1, 1, 1, 1, 1, 1, 1, 5, 1, 1, 1, 4, 4, 1, 1, 1 ],
      [ 1, 1, 1, 1, 1, 1, 1, 1, 1, 1, 1, 5, 1, 1, 1, 4, 1, 1, 1, 1 ],
      [ 1, 1, 2, 1, 1, 1, 1, 1, 1, 1, 1, 5, 1, 1, 1, 1, 1, 1, 1, 1 ],
      [ 1, 1, 1, 1, 1, 1, 1, 1, 1, 1, 1, 1, 1, 1, 1, 1, 1, 1, 1, 1 ],
      [ 1, 1, 1, 1, 1, 1, 1, 1, 1, 1, 1, 1, 1, 1, 1, 1, 1, 1, 1, 1 ]
    ],
    "unitMap": [
      [ ["auburn", 1]  ,               0, 0, 0, 0, 0, 0,              0,              0,              0, 0, 0, 0, 0, 0, 0, 0, 0, 0, 0 ],
      [ ["soldier", 1] ,               0, 0, 0, 0, 0, 0,              0,              0,              0, 0, 0, 0, 0, 0, 0, 0, 0, 0, 0 ],
      [ ["cavalier", 1],               0, 0, 0, 0, 0, 0,              0,              0,              0, 0, 0, 0, 0, 0, 0, 0, 0, 0, 0 ],
      [ ["cavalier", 1],               0, 0, 0, 0, 0, 0,              0,              0,              0, 0, 0, 0, 0, 0, 0, 0, 0, 0, 0 ],
      [ ["fighter", 1] ,               0, 0, 0, 0, 0, 0, ["soldier", 2],              0, ["soldier", 2], 0, 0, 0, 0, 0, 0, 0, 0, 0, 0 ],
      [               0,               0, 0, 0, 0, 0, 0,              0, ["arcanist", 2],             0, 0, 0, 0, 0, 0, 0, 0, 0, 0, 0 ],
      [               0,               0, 0, 0, 0, 0, 0, ["soldier", 2],              0, ["soldier", 2], 0, 0, 0, 0, 0, 0, 0, 0, 0, 0 ],
      [               0, ["arcanist", 3], 0, 0, 0, 0, 0,              0,              0,              0, 0, 0, 0, 0, 0, 0, 0, 0, 0, 0 ],
      [               0,               0, 0, 0, 0, 0, 0,              0,              0,              0, 0, 0, 0, 0, 0, 0, 0, 0, 0, 0 ],
      [               0,               0, 0, 0, 0, 0, 0,              0,              0,              0, 0, 0, 0, 0, 0, 0, 0, 0, 0, 0 ],
      [               0,               0, 0, 0, 0, 0, 0,              0,              0,              0, 0, 0, 0, 0, 0, 0, 0, 0, 0, 0 ],
      [               0,               0, 0, 0, 0, 0, 0,              0,              0,              0, 0, 0, 0, 0, 0, 0, 0, 0, 0, 0 ],
      [               0,               0, 0, 0, 0, 0, 0,              0,              0,              0, 0, 0, 0, 0, 0, 0, 0, 0, 0, 0 ]
    ]
  }
}