{
  "world": {
    "background" : "images/backgrounds/bg_flat.png",
    "tileSet" : "images/tiles/ground.png",
    "frameWidth": 64,
    "frameHeight": 64,
    "framesPerLine": 2,
    "tileMap": [
      [ 1, 1, 1, 1, 1, 1, 1, 1, 1, 1, 1, 1, 1, 1, 1, 1, 1, 1, 1, 1 ],
      [ 1, 1, 1, 1, 1, 1, 1, 1, 1, 1, 1, 1, 1, 1, 1, 1, 1, 1, 1, 1 ],
      [ 1, 1, 1, 1, 1, 1, 1, 1, 1, 1, 1, 1, 1, 1, 1, 1, 1, 1, 1, 1 ],
      [ 1, 1, 2, 1, 1, 1, 1, 1, 1, 1, 1, 1, 1, 1, 1, 1, 1, 1, 1, 1 ],
      [ 1, 2, 1, 1, 1, 1, 1, 1, 1, 2, 2, 1, 1, 1, 1, 1, 1, 1, 1, 1 ],
      [ 1, 1, 1, 1, 1, 1, 1, 1, 1, 2, 2, 1, 1, 1, 1, 1, 1, 1, 1, 1 ],
      [ 1, 1, 1, 1, 1, 1, 1, 1, 1, 1, 1, 1, 1, 1, 1, 1, 1, 1, 1, 1 ],
      [ 1, 1, 1, 1, 1, 1, 1, 1, 1, 1, 1, 1, 1, 1, 1, 1, 1, 1, 1, 1 ],
      [ 1, 1, 1, 1, 1, 1, 1, 1, 1, 1, 1, 1, 1, 1, 1, 2, 2, 1, 1, 1 ],
      [ 1, 1, 1, 1, 1, 1, 1, 1, 1, 1, 1, 1, 1, 1, 1, 2, 1, 1, 1, 1 ],
      [ 1, 1, 2, 1, 1, 1, 1, 1, 1, 1, 1, 1, 1, 1, 1, 1, 1, 1, 1, 1 ],
      [ 1, 1, 1, 1, 1, 1, 1, 1, 1, 1, 1, 1, 1, 1, 1, 1, 1, 1, 1, 1 ],
      [ 1, 1, 1, 1, 1, 1, 1, 1, 1, 1, 1, 1, 1, 1, 1, 1, 1, 1, 1, 1 ]
    ],
    "unitMap": [
      [ ["soldier", 1], 0, 0, 0, 0, 0, 0,              0,              0,              0, 0, 0, 0, 0, 0, 0, 0, 0, 0, 0 ],
      [              0, 0, 0, 0, 0, 0, 0,              0,              0,              0, 0, 0, 0, 0, 0, 0, 0, 0, 0, 0 ],
      [ ["soldier", 1], 0, 0, 0, 0, 0, 0,              0,              0,              0, 0, 0, 0, 0, 0, 0, 0, 0, 0, 0 ],
      [              0, 0, 0, 0, 0, 0, 0,              0,              0,              0, 0, 0, 0, 0, 0, 0, 0, 0, 0, 0 ],
      [              0, 0, 0, 0, 0, 0, 0, ["soldier", 2],              0, ["soldier", 2], 0, 0, 0, 0, 0, 0, 0, 0, 0, 0 ],
      [              0, 0, 0, 0, 0, 0, 0,              0, ["soldier", 2],              0, 0, 0, 0, 0, 0, 0, 0, 0, 0, 0 ],
      [              0, 0, 0, 0, 0, 0, 0, ["soldier", 2],              0, ["soldier", 2], 0, 0, 0, 0, 0, 0, 0, 0, 0, 0 ],
      [              0, 0, 0, 0, 0, 0, 0,              0,              0,              0, 0, 0, 0, 0, 0, 0, 0, 0, 0, 0 ],
      [              0, 0, 0, 0, 0, 0, 0,              0,              0,              0, 0, 0, 0, 0, 0, 0, 0, 0, 0, 0 ],
      [              0, 0, 0, 0, 0, 0, 0,              0,              0,              0, 0, 0, 0, 0, 0, 0, 0, 0, 0, 0 ],
      [              0, 0, 0, 0, 0, 0, 0,              0,              0,              0, 0, 0, 0, 0, 0, 0, 0, 0, 0, 0 ],
      [              0, 0, 0, 0, 0, 0, 0,              0,              0,              0, 0, 0, 0, 0, 0, 0, 0, 0, 0, 0 ],
      [              0, 0, 0, 0, 0, 0, 0,              0,              0,              0, 0, 0, 0, 0, 0, 0, 0, 0, 0, 0 ]
    ]
  }
}